Pathway	Group
PID_RETINOIC_ACID_PATHWAY	Metabolism
HALLMARK_GLYCOLYSIS	Metabolism
HALLMARK_FATTY_ACID_METABOLISM	Metabolism
GO_REGULATION_OF_FATTY_ACID_OXIDATION	Metabolism
HALLMARK_HEME_METABOLISM	Metabolism
HALLMARK_OXIDATIVE_PHOSPHORYLATION	Metabolism
HALLMARK_XENOBIOTIC_METABOLISM	Metabolism
PID_RETINOIC_ACID_PATHWAY	Metabolism
GO_LACTATE_METABOLIC_PROCESS	Metabolism
GO_CELLULAR_ALDEHYDE_METABOLIC_PROCESS	Metabolism
HALLMARK_CHOLESTEROL_HOMEOSTASIS	Metabolism
GO_FOLATE_IMPORT_ACROSS_PLASMA_MEMBRANE	Metabolism
GO_TETRAHYDROFOLATE_BIOSYNTHETIC_PROCESS	Metabolism
GO_TETRAHYDROFOLATE_METABOLIC_PROCESS	Metabolism
KEGG_FOLATE_BIOSYNTHESIS	Metabolism
WP_FOLATEALCOHOL_AND_CANCER_PATHWAY_HYPOTHESES	Metabolism
GO_GLUTAMATE_BIOSYNTHETIC_PROCESS	Metabolism
GO_GLUCOCORTICOID_BIOSYNTHETIC_PROCESS	Metabolism
GO_PROGESTERONE_BIOSYNTHETIC_PROCESS	Metabolism
WP_COMPUTATIONAL_MODEL_OF_AEROBIC_GLYCOLYSIS	Metabolism
REACTOME_GLUCONEOGENESIS	Metabolism
GO_IRON_IMPORT_INTO_CELL	Metabolism
REACTOME_IRON_UPTAKE_AND_TRANSPORT	Metabolism
GO_ENDOCYTOSIS	CellProcesses_Vesicle
GO_RECEPTOR_MEDIATED_ENDOCYTOSIS	CellProcesses_Vesicle
GO_CLATHRIN_DEPENDENT_ENDOCYTOSIS	CellProcesses_Vesicle
KEGG_ENDOCYTOSIS	CellProcesses_Vesicle
GO_CAVEOLIN_MEDIATED_ENDOCYTOSIS	CellProcesses_Vesicle
GO_CALCIUM_ION_REGULATED_EXOCYTOSIS	CellProcesses_Vesicle
GO_EXOCYTOSIS	CellProcesses_Vesicle
KEGG_FC_GAMMA_R_MEDIATED_PHAGOCYTOSIS	CellProcesses_Vesicle
GO_PHAGOCYTOSIS	CellProcesses_Vesicle
GO_ENDOPLASMIC_RETICULUM_TO_GOLGI_VESICLE_MEDIATED_TRANSPORT	CellProcesses_Vesicle
GO_PHAGOCYTIC_VESICLE	CellProcesses_Vesicle
GO_MICROVESICLE	CellProcesses_Vesicle
GO_VESICLE_TETHERING	CellProcesses_Vesicle
GO_SECRETORY_VESICLE	CellProcesses_Vesicle
GO_ENDOCYTIC_VESICLE	CellProcesses_Vesicle
GO_EXOCYTIC_VESICLE	CellProcesses_Vesicle
GO_GOLGI_ASSOCIATED_VESICLE	CellProcesses_Vesicle
GO_GOLGI_VESICLE_TRANSPORT	CellProcesses_Vesicle
GO_POSITIVE_REGULATION_OF_VESICLE_FUSION	CellProcesses_Vesicle
GO_ENDOSOMAL_VESICLE_FUSION	CellProcesses_Vesicle
GO_EXTRACELLULAR_VESICLE_BIOGENESIS	CellProcesses_Vesicle
KEGG_LYSOSOME	CellProcesses_Vesicle
GO_PHAGOLYSOSOME	CellProcesses_Vesicle
GO_AUTOLYSOSOME	CellProcesses_Vesicle
GO_LYSOZYME_ACTIVITY	CellProcesses_Vesicle
GO_ENDOLYSOSOME	CellProcesses_Vesicle
GO_MEMBRANE_BIOGENESIS	Cell_Processes
GO_MITOCHONDRION_MORPHOGENESIS	Cell_Processes
KEGG_MELANOGENESIS	Cell_Processes
REACTOME_MELANIN_BIOSYNTHESIS	Cell_Processes
BIOCARTA_INSULIN_PATHWAY	Metabolism_Insulin
GO_CELLULAR_RESPONSE_TO_INSULIN_LIKE_GROWTH_FACTOR_STIMULUS	Metabolism_Insulin
GO_CELLULAR_RESPONSE_TO_INSULIN_STIMULUS	Metabolism_Insulin
GO_INSULIN_LIKE_GROWTH_FACTOR_BINDING	Metabolism_Insulin
GO_INSULIN_LIKE_GROWTH_FACTOR_RECEPTOR_SIGNALING_PATHWAY	Metabolism_Insulin
GO_INSULIN_METABOLIC_PROCESS	Metabolism_Insulin
GO_INSULIN_RECEPTOR_SIGNALING_PATHWAY	Metabolism_Insulin
GO_INSULIN_SECRETION	Metabolism_Insulin
KEGG_INSULIN_SIGNALING_PATHWAY	Metabolism_Insulin
PID_INSULIN_GLUCOSE_PATHWAY	Metabolism_Insulin
PID_INSULIN_PATHWAY	Metabolism_Insulin
REACTOME_SIGNALING_BY_TYPE_1_INSULIN_LIKE_GROWTH_FACTOR_1_RECEPTOR_IGF1R_	Metabolism_Insulin
WP_INSULIN_SIGNALLING_IN_HUMAN_ADIPOCYTES_DIABETIC_CONDITION	Metabolism_Insulin
WP_INSULIN_SIGNALLING_IN_HUMAN_ADIPOCYTES_NORMAL_CONDITION	Metabolism_Insulin
HALLMARK_EPITHELIAL_MESENCHYMAL_TRANSITION	Development
REACTOME_TGF_BETA_RECEPTOR_SIGNALING_IN_EMT_EPITHELIAL_TO_MESENCHYMAL_TRANSITION_	Development
ALONSO_METASTASIS_EMT_UP	Development
EPITHELIAL_PHASE	Development
MESENCHYMAL_PHASE	Development
REACTOME_MYOGENESIS	Development_Genesis
GO_ENDOTHELIAL_CELL_MORPHOGENESIS	Development_Genesis
GO_LYMPH_VESSEL_MORPHOGENESIS	Development_Genesis
GO_LYMPHANGIOGENESIS	Development_Genesis
GO_MESODERM_MORPHOGENESIS	Development_Genesis
GO_MESENCHYME_MORPHOGENESIS	Development_Genesis
GO_EPITHELIAL_CELL_MORPHOGENESIS	Development_Genesis
GO_MORPHOGENESIS_OF_A_POLARIZED_EPITHELIUM	Development_Genesis
GO_MORPHOGENESIS_OF_EMBRYONIC_EPITHELIUM	Development_Genesis
GO_MORPHOGENESIS_OF_AN_EPITHELIUM	Development_Genesis
GO_OOGENESIS	Development_Genesis
GO_MAMMALIAN_OOGENESIS_STAGE	Development_Genesis
GO_PLATELET_MORPHOGENESIS	Development_Genesis
HALLMARK_ANGIOGENESIS	Development_Genesis
HALLMARK_MYOGENESIS	Development_Genesis
GALIE_TUMOR_STEMNESS_GENES	Development_StemCells
GO_STEM_CELL_DIFFERENTIATION	Development_StemCells
GO_STEM_CELL_DIVISION	Development_StemCells
GO_STEM_CELL_FATE_COMMITMENT	Development_StemCells
GO_STEM_CELL_PROLIFERATION	Development_StemCells
Stem_Cell_Signature	Development_StemCells
Ovarian_CSC_Signature	Development_StemCells
REACTOME_POU5F1_OCT4_SOX2_NANOG_ACTIVATE_GENES_RELATED_TO_PROLIFERATION	Development_StemCells
REACTOME_POU5F1_OCT4_SOX2_NANOG_REPRESS_GENES_RELATED_TO_DIFFERENTIATION	Development_StemCells
GO_EPITHELIAL_CELL_DEVELOPMENT	Development_Epithelial
GO_EPITHELIAL_CELL_CELL_ADHESION	Development_Epithelial
GO_EPITHELIAL_CELL_DIFFERENTIATION	Development_Epithelial
GO_EPITHELIAL_CELL_FATE_COMMITMENT	Development_Epithelial
GO_EPITHELIAL_CELL_MATURATION	Development_Epithelial
GO_EPITHELIAL_CELL_MORPHOGENESIS	Development_Epithelial
GO_EPITHELIAL_CELL_PROLIFERATION	Development_Epithelial
GO_EPITHELIAL_FLUID_TRANSPORT	Development_Epithelial
GO_EPITHELIAL_MESENCHYMAL_CELL_SIGNALING	Development_Epithelial
GO_MESENCHYMAL_EPITHELIAL_CELL_SIGNALING	Development_Epithelial
HALLMARK_EPITHELIAL_MESENCHYMAL_TRANSITION	Development_Epithelial
GO_EPITHELIAL_TO_MESENCHYMAL_TRANSITION	Development_Epithelial
REACTOME_TGF_BETA_RECEPTOR_SIGNALING_IN_EMT_EPITHELIAL_TO_MESENCHYMAL_TRANSITION_	Development_Epithelial
GO_MESENCHYMAL_TO_EPITHELIAL_TRANSITION	Development_Epithelial
GO_ESTABLISHMENT_OF_EPITHELIAL_CELL_APICAL_BASAL_POLARITY	Development_Epithelial
GO_ESTABLISHMENT_OF_EPITHELIAL_CELL_POLARITY	Development_Epithelial
GO_REGULATION_OF_EPITHELIAL_CELL_APOPTOTIC_PROCESS	Development_Epithelial
GO_REGULATION_OF_EPITHELIAL_CELL_DIFFERENTIATION	Development_Epithelial
GO_REGULATION_OF_EPITHELIAL_CELL_MIGRATION	Development_Epithelial
GO_TRANSEPITHELIAL_TRANSPORT	Development_Epithelial
GO_ADIPONECTIN_ACTIVATED_SIGNALING_PATHWAY	Development_Adipocytes
GO_ADIPOSE_TISSUE_DEVELOPMENT	Development_Adipocytes
GO_REGULATION_OF_ADIPOSE_TISSUE_DEVELOPMENT	Development_Adipocytes
HP_ABNORMAL_ADIPOSE_TISSUE_MORPHOLOGY	Development_Adipocytes
HALLMARK_ADIPOGENESIS	Development_Adipocytes
IZADPANAH_STEM_CELL_ADIPOSE_VS_BONE_UP	Development_Adipocytes
KEGG_ADIPOCYTOKINE_SIGNALING_PATHWAY	Development_Adipocytes
URS_ADIPOCYTE_DIFFERENTIATION_UP	Development_Adipocytes
WANG_CLASSIC_ADIPOGENIC_TARGETS_OF_PPARG	Development_Adipocytes
WANG_ADIPOGENIC_GENES_REPRESSED_BY_SIRT1	Development_Adipocytes
WP_LEPTIN_AND_ADIPONECTIN	Development_Adipocytes
BIOCARTA_STRESS_PATHWAY	Cell_Response_I
CHUANG_OXIDATIVE_STRESS_RESPONSE_UP	Cell_Response_I
GO_CELL_DEATH_IN_RESPONSE_TO_OXIDATIVE_STRESS	Cell_Response_I
HALLMARK_REACTIVE_OXIGEN_SPECIES_PATHWAY	Cell_Response_I
GO_NEGATIVE_REGULATION_OF_TRANSLATION_IN_RESPONSE_TO_STRESS	Cell_Response_I
GO_RESPONSE_TO_OXIDATIVE_STRESS	Cell_Response_I
GO_INTRINSIC_APOPTOTIC_SIGNALING_PATHWAY_IN_RESPONSE_TO_HYPOXIA	Cell_Response_I
HALLMARK_HYPOXIA	Cell_Response_I
PID_HIF1A_PATHWAY	Cell_Response_I
JIANG_HYPOXIA_CANCER	Cell_Response_I
GO_DRUG_TRANSPORT	Cell_Response_I
HALLMARK_XENOBIOTIC_METABOLISM	Cell_Response_I
HALLMARK_ANDROGEN_RESPONSE	Cell_Response_I
HALLMARK_DNA_REPAIR	Cell_Response_I
KEGG_MISMATCH_REPAIR	Cell_Response_I
KEGG_HOMOLOGOUS_RECOMBINATION	Cell_Response_I
KEGG_NON_HOMOLOGOUS_END_JOINING	Cell_Response_I
GO_BASE_EXCISION_REPAIR	Cell_Response_I
REACTOME_TELOMERE_EXTENSION_BY_TELOMERASE	Cell_Response_I
REACTOME_TELOMERE_MAINTENANCE	Cell_Response_I
REACTOME_EXTENSION_OF_TELOMERES	Cell_Response_I
GO_TELOMERE_CAPPING	Cell_Response_I
GO_TELOMERE_MAINTENANCE_IN_RESPONSE_TO_DNA_DAMAGE	Cell_Response_II
CHEMORESPONSE_SIGNATURE	Cell_Response_II
HALLMARK_ANDROGEN_RESPONSE	Cell_Response_II
HALLMARK_APOPTOSIS	Cell_Response_II
HALLMARK_ESTROGEN_RESPONSE_EARLY	Cell_Response_II
HALLMARK_ESTROGEN_RESPONSE_LATE	Cell_Response_II
HALLMARK_COMPLEMENT	Cell_Response_II
HALLMARK_INFLAMMATORY_RESPONSE	Cell_Response_II
HALLMARK_INTERFERON_ALPHA_RESPONSE	Cell_Response_II
HALLMARK_INTERFERON_GAMMA_RESPONSE	Cell_Response_II
HALLMARK_UNFOLDED_PROTEIN_RESPONSE	Cell_Response_II
HALLMARK_UV_RESPONSE_DN	Cell_Response_II
HALLMARK_UV_RESPONSE_UP	Cell_Response_II
BIOCARTA_HSP27_PATHWAY	Cell_Response_II
GO_HSP70_PROTEIN_BINDING	Cell_Response_II
GO_HSP90_PROTEIN_BINDING	Cell_Response_II
GO_CELLULAR_RESPONSE_TO_GROWTH_HORMONE_STIMULUS	Cell_Response_II
GO_CELLULAR_RESPONSE_TO_INSULIN_LIKE_GROWTH_FACTOR_STIMULUS	Cell_Response_II
GO_CELLULAR_RESPONSE_TO_VASCULAR_ENDOTHELIAL_GROWTH_FACTOR_STIMULUS	Cell_Response_II
GO_GROWTH_HORMONE_SECRETION	Cell_Response_II
GO_RESPONSE_TO_GROWTH_FACTOR	Cell_Response_II
GO_RESPONSE_TO_GROWTH_HORMONE	Cell_Response_II
KEGG_ECM_RECEPTOR_INTERACTION	Tissue_Adaptation
BIOCARTA_ECM_PATHWAY	Tissue_Adaptation
NABA_ECM_REGULATORS	Tissue_Adaptation
GO_CELL_MATRIX_ADHESION	Tissue_Adaptation
GO_COLLAGEN_BINDING_INVOLVED_IN_CELL_MATRIX_ADHESION	Tissue_Adaptation
GO_COLLAGEN_CONTAINING_EXTRACELLULAR_MATRIX	Tissue_Adaptation
GO_EXTRACELLULAR_MATRIX	Tissue_Adaptation
GO_EXTRACELLULAR_MATRIX_BINDING	Tissue_Adaptation
GO_EXTRACELLULAR_MATRIX_CELL_SIGNALING	Tissue_Adaptation
GO_EXTRACELLULAR_MATRIX_DISASSEMBLY	Tissue_Adaptation
GO_REGULATION_OF_MATRIX_METALLOPEPTIDASE_SECRETION	Tissue_Adaptation
REACTOME_ACTIVATION_OF_MATRIX_METALLOPROTEINASES	Tissue_Adaptation
REACTOME_CELL_EXTRACELLULAR_MATRIX_INTERACTIONS	Tissue_Adaptation
REACTOME_DEGRADATION_OF_THE_EXTRACELLULAR_MATRIX	Tissue_Adaptation
REACTOME_FIBRONECTIN_MATRIX_FORMATION	Tissue_Adaptation
REACTOME_EXTRACELLULAR_MATRIX_ORGANIZATION	Tissue_Adaptation
REACTOME_DEGRADATION_OF_THE_EXTRACELLULAR_MATRIX	Tissue_Adaptation
GO_REGULATION_OF_EXTRACELLULAR_MATRIX_ORGANIZATION	Tissue_Adaptation
GO_REGULATION_OF_EXTRACELLULAR_MATRIX_DISASSEMBLY	Tissue_Adaptation
GO_ENDOTHELIAL_CELL_MATRIX_ADHESION_VIA_FIBRONECTIN	Tissue_Adaptation
REACTOME_COLLAGEN_FORMATION	Tissue_Adaptation
REACTOME_COLLAGEN_DEGRADATION	Tissue_Adaptation
GO_COLLAGEN_BIOSYNTHETIC_PROCESS	Tissue_Adaptation
GO_MESENCHYMAL_EPITHELIAL_CELL_SIGNALING	CellTypes_Other
MESOTHELIAL	CellTypes_Other
Mesothelial_extended	CellTypes_Other
Granulocyte_Signature	CellTypes_Other
GO_FIBROBLAST_ACTIVATION	CellTypes_Fibroblasts
GO_FIBROBLAST_GROWTH_FACTOR_ACTIVATED_RECEPTOR_ACTIVITY	CellTypes_Fibroblasts
GO_FIBROBLAST_GROWTH_FACTOR_PRODUCTION	CellTypes_Fibroblasts
GO_FIBROBLAST_GROWTH_FACTOR_RECEPTOR_SIGNALING_PATHWAY	CellTypes_Fibroblasts
GO_FIBROBLAST_MIGRATION	CellTypes_Fibroblasts
GO_FIBROBLAST_PROLIFERATION	CellTypes_Fibroblasts
GO_FIBRONECTIN_BINDING	CellTypes_Fibroblasts
GO_MYOFIBROBLAST_DIFFERENTIATION	CellTypes_Fibroblasts
GO_RESPONSE_TO_FIBROBLAST_GROWTH_FACTOR	CellTypes_Fibroblasts
HINATA_NFKB_TARGETS_FIBROBLAST_UP	CellTypes_Fibroblasts
MISHRA_CARCINOMA_ASSOCIATED_FIBROBLAST_UP	CellTypes_Fibroblasts
REACTOME_FIBRONECTIN_MATRIX_FORMATION	CellTypes_Fibroblasts
ZHONG_SECRETOME_OF_LUNG_CANCER_AND_FIBROBLAST	CellTypes_Fibroblasts
Pericyte_Signature	CellTypes_Other
M1_Macrophage	CellTypes_Macrophages
M2_Macrophage	CellTypes_Macrophages
TAM_Macrophage	CellTypes_Macrophages
TCRpos_Macrophage	CellTypes_Macrophages
CD169pos_Macrophage	CellTypes_Macrophages
Invasion_Signature	CellTypes_Macrophages
Metastasis_Macrophage_Signature	CellTypes_Macrophages
Angiogenic_Macrophage_Signature	CellTypes_Macrophages
ImmuneRegulating_Macrophage	CellTypes_Macrophages
Inflammation_Macrophage_Signature	CellTypes_Macrophages
Macrophage_ColdTumor_ImmuneResistant_Signature_Up	CellTypes_Macrophages
GO_CHAPERONE_MEDIATED_PROTEIN_FOLDING	CellTypes_Other
HALLMARK_APOPTOSIS	Cell_Death
REACTOME_SUPPRESSION_OF_APOPTOSIS	Cell_Death
REACTOME_INTRINSIC_PATHWAY_FOR_APOPTOSIS	Cell_Death
REACTOME_APOPTOSIS_INDUCED_DNA_FRAGMENTATION	Cell_Death
KEGG_APOPTOSIS	Cell_Death
GO_CELL_MATRIX_ADHESION	Adhesion
GO_CELL_CELL_ADHESIONN	Adhesion
GO_CADHERIN_BINDING_INVOLVED_IN_CELL_CELL_ADHESION	Adhesion
GO_CALCIUM_DEPENDENT_CELL_CELL_ADHESION_VIA_PLASMA_MEMBRANE_CELL_ADHESION_MOLECULES	Adhesion
GO_CALCIUM_INDEPENDENT_CELL_CELL_ADHESION_VIA_PLASMA_MEMBRANE_CELL_ADHESION_MOLECULES	Adhesion
GO_CELL_ADHESION_MEDIATED_BY_INTEGRIN	Adhesion
GO_CELL_ADHESION_MOLECULE_BINDING	Adhesion
GO_CELL_ADHESION_MOLECULE_PRODUCTION	Adhesion
GO_CELL_CELL_ADHESION	Adhesion
GO_CELL_CELL_ADHESION_MEDIATED_BY_CADHERIN	Adhesion
GO_CELL_CELL_ADHESION_MEDIATED_BY_INTEGRIN	Adhesion
GO_CELL_CELL_ADHESION_VIA_PLASMA_MEMBRANE_ADHESION_MOLECULES	Adhesion
GO_COLLAGEN_BINDING_INVOLVED_IN_CELL_MATRIX_ADHESION	Adhesion
GO_ENDOTHELIAL_CELL_MATRIX_ADHESION	Adhesion
GO_ENDOTHELIAL_CELL_MATRIX_ADHESION_VIA_FIBRONECTIN	Adhesion
GO_EPITHELIAL_CELL_CELL_ADHESION	Adhesion
GO_HETEROTYPIC_CELL_CELL_ADHESION	Adhesion
GO_HOMOPHILIC_CELL_ADHESION_VIA_PLASMA_MEMBRANE_ADHESION_MOLECULES	Adhesion
GO_HETEROPHILIC_CELL_CELL_ADHESION_VIA_PLASMA_MEMBRANE_CELL_ADHESION_MOLECULES	Adhesion
GO_HOMOTYPIC_CELL_CELL_ADHESION	Adhesion
GO_LEUKOCYTE_ADHESION_TO_ARTERIAL_ENDOTHELIAL_CELL	Adhesion
GO_LEUKOCYTE_ADHESION_TO_VASCULAR_ENDOTHELIAL_CELL	Adhesion
GO_LEUKOCYTE_CELL_CELL_ADHESION	Adhesion
GO_NEGATIVE_REGULATION_OF_CELL_ADHESION	Adhesion
GO_REGULATION_OF_CELL_ADHESION	Adhesion
GO_REGULATION_OF_CELL_MATRIX_ADHESION	Adhesion
GO_SYNAPTIC_MEMBRANE_ADHESION	Adhesion
WP_INTEGRINMEDIATED_CELL_ADHESION	Adhesion
GO_NEURON_CELL_CELL_ADHESION	Adhesion
GO_POSITIVE_REGULATION_OF_LEUKOCYTE_ADHESION_TO_VASCULAR_ENDOTHELIAL_CELL	Adhesion
GO_POSITIVE_REGULATION_OF_LEUKOCYTE_CELL_CELL_ADHESION	Adhesion
GO_POSITIVE_REGULATION_OF_CELL_CELL_ADHESION_MEDIATED_BY_INTEGRIN	Adhesion
GO_REGULATION_OF_CELL_ADHESION_MEDIATED_BY_INTEGRIN	Adhesion
GO_REGULATION_OF_CELL_CELL_ADHESION_MEDIATED_BY_INTEGRIN	Adhesion
CALCIUM_INDEPENDENT_CELL_CELL_ADHESION	Adhesion
GO_CALC_DEPEND_CELL_CELL_ADHESION_VIA_PLASMA_MEMBR_MOLEC	Adhesion
Integrin_ecm_Signature	Adhesion
GO_ENDOTHELIAL_CELL_PROLIFERATION	Proliferation
GO_KERATINOCYTE_PROLIFERATION	Proliferation
GO_MESENCHYMAL_CELL_PROLIFERATION	Proliferation
GO_MESENCHYMAL_STEM_CELL_PROLIFERATION	Proliferation
GO_LEUKOCYTE_PROLIFERATION	Proliferation
GO_MACROPHAGE_PROLIFERATION	Proliferation
GO_FIBROBLAST_PROLIFERATION	Proliferation
GO_EPITHELIAL_CELL_PROLIFERATION	Proliferation
GO_CANONICAL_WNT_SIGNALING_PATHWAY_INVOLVED_IN_REGULATION_OF_CELL_PROLIFERATION	Proliferation
HALLMARK_WNT_BETA_CATENIN_SIGNALING	Proliferation
GO_B_CELL_PROLIFERATION	Proliferation
GO_ACTIVATED_T_CELL_PROLIFERATION	Proliferation
GO_VASCULAR_ENDOTHELIAL_CELL_PROLIFERATION	Proliferation
GO_T_CELL_PROLIFERATION	Proliferation
GO_REGULATION_OF_STEM_CELL_PROLIFERATION	Proliferation
REACTOME_VEGFR2_MEDIATED_CELL_PROLIFERATION	Proliferation
HALLMARK_MITOTIC_SPINDLE	Proliferation
REACTOME_SIGNALING_BY_EGFR	Proliferation
REACTOME_SIGNALING_BY_EGFR_IN_CANCER	Proliferation
BIOCARTA_EGF_PATHWAY	Proliferation
HALLMARK_TGF_BETA_SIGNALING	Proliferation
KARAKAS_TGFB1_SIGNALING	Proliferation
REACTOME_SIGNALING_BY_TGFB_FAMILY_MEMBERS	Proliferation
BIOCARTA_PDGF_PATHWAY	Proliferation
REACTOME_SIGNALING_BY_PDGF	Proliferation
GO_INSULIN_LIKE_GROWTH_FACTOR_RECEPTOR_SIGNALING_PATHWAY	Proliferation
GO_FIBROBLAST_GROWTH_FACTOR_RECEPTOR_SIGNALING_PATHWAY	Proliferation
HALLMARK_E2F_TARGETS	Proliferation
HALLMARK_G2M_CHECKPOINT	Proliferation
HALLMARK_MYC_TARGETS_V1	Proliferation
HALLMARK_MYC_TARGETS_V2	Proliferation
HALLMARK_P53_PATHWAY	Proliferation
HALLMARK_MITOTIC_SPINDLE	Proliferation
REACTOME_SIGNALING_BY_EGFR	Signaling_1
REACTOME_SIGNALING_BY_EGFR_IN_CANCER	Signaling_1
BIOCARTA_EGF_PATHWAY	Signaling_1
HALLMARK_WNT_BETA_CATENIN_SIGNALING	Signaling_1
GO_CANONICAL_WNT_SIGNALING_PATHWAY_INVOLVED_IN_REGULATION_OF_CELL_PROLIFERATION	Signaling_1
REACTOME_SIGNALING_BY_WNT_IN_CANCER	Signaling_1
HALLMARK_TGF_BETA_SIGNALING	Signaling_1
KARAKAS_TGFB1_SIGNALING	Signaling_1
REACTOME_SIGNALING_BY_TGFB_FAMILY_MEMBERS	Signaling_1
REACTOME_SIGNALING_BY_PDGF	Signaling_1
GO_INSULIN_LIKE_GROWTH_FACTOR_RECEPTOR_SIGNALING_PATHWAY	Signaling_1
GO_FIBROBLAST_GROWTH_FACTOR_RECEPTOR_SIGNALING_PATHWAY	Signaling_1
HALLMARK_HEDGEHOG_SIGNALING	Signaling_1
HALLMARK_IL2_STAT5_SIGNALING	Signaling_1
HALLMARK_NOTCH_SIGNALING	Signaling_1
HALLMARK_IL6_JAK_STAT3_SIGNALING	Signaling_1
HALLMARK_KRAS_SIGNALING_DN	Signaling_1
HALLMARK_KRAS_SIGNALING_UP	Signaling_1
HALLMARK_PI3K_AKT_MTOR_SIGNALING	Signaling_1
HALLMARK_MTORC1_SIGNALING	Signaling_1
HALLMARK_TNFA_SIGNALING_VIA_NFKB	Signaling_1
CALCIUM_MEDIATED_SIGNALING	Signaling_1
MAPK_PATHWAY	Signaling_1
GO_ANDROGEN_RECEPTOR_SIGNALING_PATHWAY	Signaling_1
WP_ESTROGEN_SIGNALING_PATHWAY	Signaling_1
REACTOME_SIGNALING_BY_VEGF	Signaling_1
KEGG_VEGF_SIGNALING_PATHWAY	Signaling_2
REACTOME_VEGFR2_MEDIATED_CELL_PROLIFERATION	Signaling_2
WP_VEGFAVEGFR2_SIGNALING_PATHWAY	Signaling_2
GO_ANGIOTENSIN_ACTIVATED_SIGNALING_PATHWAY	Signaling_2
REACTOME_SIGNALLING_TO_ERKS	Signaling_2
REACTOME_RAF_ACTIVATION	Signaling_2
REACTOME_SIGNALING_BY_BRAF_AND_RAF_FUSIONS	Signaling_2
REACTOME_ONCOGENIC_MAPK_SIGNALING	Signaling_2
BIOCARTA_ALK_PATHWAY	Signaling_2
BIOCARTA_MET_PATHWAY	Signaling_2
REACTOME_MET_ACTIVATES_PI3K_AKT_SIGNALING	Signaling_2
REACTOME_MET_ACTIVATES_RAS_SIGNALING	Signaling_2
REACTOME_MET_RECEPTOR_ACTIVATION	Signaling_2
BILD_SRC_ONCOGENIC_SIGNATURE	Signaling_2
GO_GLUTAMATE_RECEPTOR_SIGNALING_PATHWAY	Signaling_2
GO_PROGESTERONE_RECEPTOR_SIGNALING_PATHWAY	Signaling_2
GO_EPIDERMAL_GROWTH_FACTOR_RECEPTOR_SIGNALING_PATHWAY	Signaling_2
GO_HEPATOCYTE_GROWTH_FACTOR_RECEPTOR_SIGNALING_PATHWAY	Signaling_2
GO_NERVE_GROWTH_FACTOR_SIGNALING_PATHWAY	Signaling_2
GO_PLATELET_DERIVED_GROWTH_FACTOR_RECEPTOR_ALPHA_SIGNALING_PATHWAY	Signaling_2
GO_PLATELET_DERIVED_GROWTH_FACTOR_RECEPTOR_BETA_SIGNALING_PATHWAY	Signaling_2
GO_PLATELET_DERIVED_GROWTH_FACTOR_RECEPTOR_SIGNALING_PATHWAY	Signaling_2
GO_TRANSFORMING_GROWTH_FACTOR_BETA_RECEPTOR_SIGNALING_PATHWAY	Signaling_2
GO_VASCULAR_ENDOTHELIAL_GROWTH_FACTOR_RECEPTOR_SIGNALING_PATHWAY	Signaling_2
GO_VASCULAR_ENDOTHELIAL_GROWTH_FACTOR_SIGNALING_PATHWAY	Signaling_2
REACTOME_GROWTH_HORMONE_RECEPTOR_SIGNALING	Signaling_2
GO_MACROPHAGE_FUSION	Cell_Fusion
GO_MEMBRANE_FUSION	Cell_Fusion
GO_MYOBLAST_FUSION	Cell_Fusion
GO_MYOBLAST_FUSION_INVOLVED_IN_SKELETAL_MUSCLE_REGENERATION	Cell_Fusion
GO_OSTEOCLAST_FUSION	Cell_Fusion
GO_PLASMA_MEMBRANE_FUSION	Cell_Fusion
GO_SNARE_BINDING	Cell_Fusion
GO_SNARE_COMPLEX	Cell_Fusion
GO_SNARE_COMPLEX_ASSEMBLY	Cell_Fusion
GO_CHRONIC_INFLAMMATORY_RESPONSE	CellResponse_Inflammation
GO_ACUTE_INFLAMMATORY_RESPONSE	CellResponse_Inflammation
GO_INFLAMMATORY_RESPONSE	CellResponse_Inflammation
GO_INFLAMMATORY_RESPONSE_TO_WOUNDING	CellResponse_Inflammation
GO_LEUKOCYTE_CHEMOTAXIS_INVOLVED_IN_INFLAMMATORY_RESPONSE	CellResponse_Inflammation
GO_LEUKOCYTE_MIGRATION_INVOLVED_IN_INFLAMMATORY_RESPONSE	CellResponse_Inflammation
GO_WOUND_HEALING_INVOLVED_IN_INFLAMMATORY_RESPONSE	CellResponse_Inflammation
HALLMARK_INFLAMMATORY_RESPONSE	CellResponse_Inflammation
WP_IL10_ANTIINFLAMMATORY_SIGNALING_PATHWAY	CellResponse_Inflammation
EINAV_INTERFERON_SIGNATURE_IN_CANCER	CellResponse_Inflammation
GO_CELLULAR_RESPONSE_TO_INTERFERON_ALPHA	CellResponse_Inflammation
GO_INTERFERON_ALPHA_PRODUCTION	CellResponse_Inflammation
GO_CELLULAR_RESPONSE_TO_INTERFERON_BETA	CellResponse_Inflammation
GO_INTERFERON_BETA_PRODUCTION	CellResponse_Inflammation
GO_INTERFERON_GAMMA_PRODUCTION	CellResponse_Inflammation
GO_INTERFERON_GAMMA_MEDIATED_SIGNALING_PATHWAY	CellResponse_Inflammation
HALLMARK_INTERFERON_ALPHA_RESPONSE	CellResponse_Inflammation
HALLMARK_INTERFERON_GAMMA_RESPONSE	CellResponse_Inflammation
Pro_Inflammatory	CellResponse_Inflammation
Anti_Inflammatory	CellResponse_Inflammation
Tumor_Immunesuppression_Signature	CellResponse_Inflammation
GO_B_CELL_CHEMOTAXIS	Motility
GO_CELL_CHEMOTAXIS	Motility
GO_DENDRITIC_CELL_CHEMOTAXIS	Motility
GO_GRANULOCYTE_CHEMOTAXIS	Motility
GO_LEUKOCYTE_CHEMOTAXIS	Motility
GO_LEUKOCYTE_CHEMOTAXIS_INVOLVED_IN_INFLAMMATORY_RESPONSE	Motility
GO_LYMPHOCYTE_CHEMOTAXIS	Motility
GO_MACROPHAGE_CHEMOTAXIS	Motility
GO_MONOCYTE_CHEMOTAXIS	Motility
GO_NATURAL_KILLER_CELL_CHEMOTAXIS	Motility
GO_CELL_MOTILITY	Motility
WU_CELL_MIGRATION	Motility
HO_LIVER_CANCER_VASCULAR_INVASION	Motility
MINGUEZ_LIVER_CANCER_VASCULAR_INVASION_UP	Motility
BIOCARTA_HDAC_PATHWAY	Epigenetic_regulation
PID_HDAC_CLASSI_PATHWAY	Epigenetic_regulation
PID_HDAC_CLASSII_PATHWAY	Epigenetic_regulation
PID_HDAC_CLASSIII_PATHWAY	Epigenetic_regulation
REACTOME_HDACS_DEACETYLATE_HISTONES	Epigenetic_regulation
GO_CELLULAR_RESPONSE_TO_VITAMIN_D	VitaminD
GO_REGULATION_OF_VITAMIN_D_BIOSYNTHETIC_PROCESS	VitaminD
GO_RESPONSE_TO_VITAMIN_D	VitaminD
GO_VITAMIN_D3_METABOLIC_PROCESS	VitaminD
GO_VITAMIN_D_BINDING	VitaminD
GO_VITAMIN_D_BIOSYNTHETIC_PROCESS	VitaminD
GO_VITAMIN_D_METABOLIC_PROCESS	VitaminD
GO_VITAMIN_D_RECEPTOR_SIGNALING_PATHWAY	VitaminD
HP_ABNORMALITY_OF_VITAMIN_D_METABOLISM	VitaminD
REACTOME_VITAMIN_D_CALCIFEROL_METABOLISM	VitaminD
WP_VITAMIN_D_IN_INFLAMMATORY_DISEASES	VitaminD
WP_VITAMIN_D_RECEPTOR_PATHWAY	VitaminD
KEGG_BREAST_CANCER	Cancer
Tumor_Immunesuppression_Signature	Cancer
HotTumor_ImmuneResponsive_Signature	Cancer
ColdTumor_ImmuneResistant_Signature_Up	Cancer
ColdTumor_ImmuneResistant_Signature_Down	Cancer
ColdTumor_ExclusionProgram_Short	Cancer
LU_TUMOR_VASCULATURE_UP	Cancer
LIN_TUMOR_ESCAPE_FROM_IMMUNE_ATTACK	Cancer
LU_TUMOR_ANGIOGENESIS_UP	Cancer
MONNIER_POSTRADIATION_TUMOR_ESCAPE_UP	Cancer
REACTOME_OVARIAN_TUMOR_DOMAIN_PROTEASES	Cancer
WP_INTERACTIONS_BETWEEN_IMMUNE_CELLS_AND_MICRORNAS_IN_TUMOR_MICROENVIRONMENT	Cancer
YAGUE_PRETUMOR_DRUG_RESISTANCE_UP	Cancer
GALIE_TUMOR_STEMNESS_GENES	Cancer
ANASTASSIOU_MULTICANCER_INVASIVENESS_SIGNATURE	Cancer
OUELLET_CULTURED_OVARIAN_CANCER_INVASIVE_VS_LMP_UP	Cancer
PUIFFE_INVASION_INHIBITED_BY_ASCITES_UP	Cancer_Ovarian
WP_MFAP5MEDIATED_OVARIAN_CANCER_CELL_MOTILITY_AND_INVASIVENESS	Cancer_Ovarian
BONOME_OVARIAN_CANCER_POOR_SURVIVAL_UP	Cancer_Ovarian
GO_OVARIAN_FOLLICLE_DEVELOPMENT	Cancer_Ovarian
WP_APOPTOSISRELATED_NETWORK_DUE_TO_ALTERED_NOTCH3_IN_OVARIAN_CANCER	Cancer_Ovarian
HP_ASCITES	Cancer_Ovarian
REACTOME_TGF_BETA_RECEPTOR_SIGNALING_IN_EMT_EPITHELIAL_TO_MESENCHYMAL_TRANSITION_	Cancer_Ovarian
GO_MAMMALIAN_OOGENESIS_STAGE	Cancer_Ovarian
GO_ANTIGEN_PROCESSING_AND_PRESENTATION	Antigen_Presentation
GO_ANTIGEN_PROCESSING_AND_PRESENTATION_ENDOGENOUS_LIPID_ANTIGEN_VIA_MHC_CLASS_IB	Antigen_Presentation
GO_ANTIGEN_PROCESSING_AND_PRESENTATION_OF_ENDOGENOUS_ANTIGEN	Antigen_Presentation
GO_ANTIGEN_PROCESSING_AND_PRESENTATION_OF_ENDOGENOUS_PEPTIDE_ANTIGEN	Antigen_Presentation
GO_ANTIGEN_PROCESSING_AND_PRESENTATION_OF_LIPID_ANTIGEN_VIA_MHC_CLASS_IB	Antigen_Presentation
GO_ANTIGEN_PROCESSING_AND_PRESENTATION_OF_PEPTIDE_OR_POLYSACCHARIDE_ANTIGEN_VIA_MHC_CLASS_II	Antigen_Presentation
GO_ANTIGEN_RECEPTOR_MEDIATED_SIGNALING_PATHWAY	Antigen_Presentation
GO_T_CELL_ANTIGEN_PROCESSING_AND_PRESENTATION	Antigen_Presentation
PELLICCIOTTA_HDAC_IN_ANTIGEN_PRESENTATION_UP	Antigen_Presentation
REACTOME_CLASS_I_MHC_MEDIATED_ANTIGEN_PROCESSING_PRESENTATION	Antigen_Presentation
REACTOME_MHC_CLASS_II_ANTIGEN_PRESENTATION	Antigen_Presentation
GO_ACTIVATED_T_CELL_PROLIFERATION	Antigen_Presentation
GO_ALPHA_BETA_T_CELL_ACTIVATION_INVOLVED_IN_IMMUNE_RESPONSE	Antigen_Presentation
GO_GAMMA_DELTA_T_CELL_ACTIVATION	Antigen_Presentation
GO_C_X_C_CHEMOKINE_RECEPTOR_ACTIVITY	Cell_communication_Chemokine
GO_CCR1_CHEMOKINE_RECEPTOR_BINDING	Cell_communication_Chemokine
GO_CCR2_CHEMOKINE_RECEPTOR_BINDING	Cell_communication_Chemokine
GO_CCR3_CHEMOKINE_RECEPTOR_BINDING	Cell_communication_Chemokine
GO_CCR5_CHEMOKINE_RECEPTOR_BINDING	Cell_communication_Chemokine
GO_CCR6_CHEMOKINE_RECEPTOR_BINDING	Cell_communication_Chemokine
GO_CCR_CHEMOKINE_RECEPTOR_BINDING	Cell_communication_Chemokine
GO_CELL_CHEMOTAXIS	Cell_communication_Chemokine
GO_CHEMOKINE_ACTIVITY	Cell_communication_Chemokine
GO_CHEMOKINE_BINDING	Cell_communication_Chemokine
GO_CHEMOKINE_BIOSYNTHETIC_PROCESS	Cell_communication_Chemokine
GO_CHEMOKINE_PRODUCTION	Cell_communication_Chemokine
GO_CHEMOKINE_SECRETION	Cell_communication_Chemokine
GO_DENDRITIC_CELL_CHEMOTAXIS	Cell_communication_Chemokine
GO_LEUKOCYTE_CHEMOTAXIS_INVOLVED_IN_INFLAMMATORY_RESPONSE	Cell_communication_Chemokine
GO_LYMPHOCYTE_CHEMOTAXIS	Cell_communication_Chemokine
GO_MACROPHAGE_CHEMOTAXIS	Cell_communication_Chemokine
GO_MONOCYTE_CHEMOTAXIS	Cell_communication_Chemokine
GO_MONOCYTE_CHEMOTACTIC_PROTEIN_1_PRODUCTION	Cell_communication_Chemokine
GO_NATURAL_KILLER_CELL_CHEMOTAXIS	Cell_communication_Chemokine
GO_NEUTROPHIL_CHEMOTAXIS	Cell_communication_Chemokine
GO_REGULATION_OF_CELL_CHEMOTAXIS_TO_FIBROBLAST_GROWTH_FACTOR	Cell_communication_Chemokine
GO_REGULATION_OF_CHEMOKINE_MEDIATED_SIGNALING_PATHWAY	Cell_communication_Chemokine
GO_REGULATION_OF_CHEMOTAXIS	Cell_communication_Chemokine
GO_RESPONSE_TO_CHEMOKINE	Cell_communication_Chemokine
KEGG_CHEMOKINE_SIGNALING_PATHWAY	Cell_communication_Chemokine
REACTOME_CHEMOKINE_RECEPTORS_BIND_CHEMOKINES	Cell_communication_Chemokine
WP_CHEMOKINE_SIGNALING_PATHWAY	Cell_communication_Chemokine
BIOCARTA_CYTOKINE_PATHWAY	Cell_communication_Cytokine
GO_NEGATIVE_REGULATION_OF_CYTOKINE_BIOSYNTHETIC_PROCESS	Cell_communication_Cytokine
GO_POSITIVE_REGULATION_OF_CYTOKINE_BIOSYNTHETIC_PROCESS	Cell_communication_Cytokine
GO_CD4_POSITIVE_ALPHA_BETA_T_CELL_CYTOKINE_PRODUCTION	Cell_communication_Cytokine
GO_CYTOKINE_MEDIATED_SIGNALING_PATHWAY	Cell_communication_Cytokine
GO_CYTOKINE_PRODUCTION	Cell_communication_Cytokine
GO_CYTOKINE_PRODUCTION_INVOLVED_IN_IMMUNE_RESPONSE	Cell_communication_Cytokine
GO_CYTOKINE_PRODUCTION_INVOLVED_IN_INFLAMMATORY_RESPONSE	Cell_communication_Cytokine
GO_CYTOKINE_RECEPTOR_ACTIVITY	Cell_communication_Cytokine
GO_CYTOKINE_SECRETION	Cell_communication_Cytokine
GO_DENDRITIC_CELL_CYTOKINE_PRODUCTION	Cell_communication_Cytokine
GO_MACROPHAGE_CYTOKINE_PRODUCTION	Cell_communication_Cytokine
GO_NATURAL_KILLER_CELL_CYTOKINE_PRODUCTION	Cell_communication_Cytokine
KEGG_ADIPOCYTOKINE_SIGNALING_PATHWAY	Cell_communication_Cytokine
GO_TUMOR_NECROSIS_FACTOR_SUPERFAMILY_CYTOKINE_PRODUCTION	Cell_communication_Cytokine
GO_T_HELPER_1_CELL_CYTOKINE_PRODUCTION	Cell_communication_Cytokine
GO_T_HELPER_2_CELL_CYTOKINE_PRODUCTION	Cell_communication_Cytokine
KEGG_CYTOKINE_CYTOKINE_RECEPTOR_INTERACTION	Cell_communication_Cytokine
REACTOME_CYTOKINE_SIGNALING_IN_IMMUNE_SYSTEM	Cell_communication_Cytokine
REACTOME_CELL_CELL_COMMUNICATION	Cell_communication_Cytokine
HALLMARK_TNFA_SIGNALING_VIA_NFKB	Cell_communication_Cytokine
REACTOME_TNF_SIGNALING	Cell_communication_Cytokine
BIOCARTA_IFNA_PATHWAY	Cell_communication_Cytokine
BIOCARTA_IFNG_PATHWAY	Cell_communication_Cytokine
PID_IFNG_PATHWAY	Cell_communication_Cytokine
BIOCARTA_TGFB_PATHWAY	Cell_communication_Cytokine
KEGG_TGF_BETA_SIGNALING_PATHWAY	Cell_communication_Cytokine
REACTOME_SIGNALING_BY_TGF_BETA_RECEPTOR_COMPLEX_IN_CANCER	Cell_communication_Cytokine
PID_GMCSF_PATHWAY	Cell_communication_Cytokine
GO_LIPID_GLYCOSYLATION	Glycosylation_1
GO_GLYCOLIPID_BIOSYNTHETIC_PROCESS	Glycosylation_1
GO_GLYCOPROTEIN_BIOSYNTHETIC_PROCESS	Glycosylation_1
GO_GLYCOSAMINOGLYCAN_BINDING	Glycosylation_1
GO_GLYCOSPHINGOLIPID_BIOSYNTHETIC_PROCESS	Glycosylation_1
GO_GLYCOSYLATION	Glycosylation_1
GO_PEPTIDE_CROSS_LINKING_VIA_CHONDROITIN_4_SULFATE_GLYCOSAMINOGLYCAN	Glycosylation_1
GO_PROTEIN_DEGLYCOSYLATION	Glycosylation_1
GO_PROTEIN_GLYCOSYLATION_IN_GOLGI	Glycosylation_1
GO_PROTEIN_N_LINKED_GLYCOSYLATION	Glycosylation_1
GO_PROTEIN_O_LINKED_GLYCOSYLATION	Glycosylation_1
GO_REGULATION_OF_PROTEIN_GLYCOSYLATION	Glycosylation_1
HP_ABNORMAL_GLYCOSYLATION	Glycosylation_1
HP_ABNORMAL_PROTEIN_GLYCOSYLATION	Glycosylation_1
HP_ABNORMAL_PROTEIN_O_LINKED_GLYCOSYLATION	Glycosylation_1
HP_ABNORMALITY_OF_GLYCOSPHINGOLIPID_METABOLISM	Glycosylation_1
KEGG_GLYCOLYSIS_GLUCONEOGENESIS	Glycosylation_1
KEGG_GLYCOSAMINOGLYCAN_BIOSYNTHESIS_CHONDROITIN_SULFATE	Glycosylation_1
KEGG_GLYCOSAMINOGLYCAN_BIOSYNTHESIS_HEPARAN_SULFATE	Glycosylation_1
KEGG_GLYCOSAMINOGLYCAN_DEGRADATION	Glycosylation_1
KEGG_GLYCOSPHINGOLIPID_BIOSYNTHESIS_GANGLIO_SERIES	Glycosylation_1
KEGG_GLYCOSPHINGOLIPID_BIOSYNTHESIS_GLOBO_SERIES	Glycosylation_1
NABA_ECM_GLYCOPROTEINS	Glycosylation_1
REACTOME_GLYCOSAMINOGLYCAN_METABOLISM	Glycosylation_1
REACTOME_GLYCOSPHINGOLIPID_METABOLISM	Glycosylation_1
REACTOME_O_LINKED_GLYCOSYLATION	Glycosylation_1
REACTOME_O_LINKED_GLYCOSYLATION_OF_MUCINS	Glycosylation_1
WP_GLYCOGEN_SYNTHESIS_AND_DEGRADATION	Glycosylation_1
WP_GLYCOLYSIS_AND_GLUCONEOGENESIS	Glycosylation_1
WP_HIF1A_AND_PPARG_REGULATION_OF_GLYCOLYSIS	Glycosylation_1
WP_ROLE_OF_ALTERED_GLYCOLYSATION_OF_MUC1_IN_TUMOUR_MICROENVIRONMENT	Glycosylation_1
GO_CHONDROITIN_SULFATE_PROTEOGLYCAN_BIOSYNTHETIC_PROCESS	Glycosylation_1
GO_GLUCURONOSYL_N_ACETYLGALACTOSAMINYL_PROTEOGLYCAN_4_BETA_N_ACETYLGALACTOSAMINYLTRANSFERASE_ACTIVITY	Glycosylation_1
GO_GLYCOSAMINOGLYCAN_BINDING	Glycosylation_2
GO_HEPARAN_SULFATE_PROTEOGLYCAN_BINDING	Glycosylation_2
GO_HEPARAN_SULFATE_PROTEOGLYCAN_BIOSYNTHETIC_PROCESS	Glycosylation_2
GO_N_GLYCAN_PROCESSING	Glycosylation_2
GO_O_GLYCAN_PROCESSING	Glycosylation_2
GO_PEPTIDOGLYCAN_BINDING	Glycosylation_2
GO_PEPTIDOGLYCAN_IMMUNE_RECEPTOR_ACTIVITY	Glycosylation_2
GO_PEPTIDOGLYCAN_MURALYTIC_ACTIVITY	Glycosylation_2
GO_PROTEOGLYCAN_METABOLIC_PROCESS	Glycosylation_2
KEGG_N_GLYCAN_BIOSYNTHESIS	Glycosylation_2
KEGG_O_GLYCAN_BIOSYNTHESIS	Glycosylation_2
REACTOME_ECM_PROTEOGLYCANS	Glycosylation_2
GO_DOLICHYL_DIPHOSPHOOLIGOSACCHARIDE_PROTEIN_GLYCOTRANSFERASE_ACTIVITY	Glycosylation_2
REACTOME_BIOSYNTHESIS_OF_THE_N_GLYCAN_PRECURSOR_DOLICHOL_LIPID_LINKED_OLIGOSACCHARIDE_LLO_AND_TRANSFER_TO_A_NASCENT_PROTEIN	Glycosylation_2
REACTOME_N_GLYCAN_ANTENNAE_ELONGATION	Glycosylation_2
REACTOME_REACTIONS_SPECIFIC_TO_THE_COMPLEX_N_GLYCAN_SYNTHESIS_PATHWAY	Glycosylation_2
GO_DOLICHYL_PHOSPHATE_MANNOSE_PROTEIN_MANNOSYLTRANSFERASE_ACTIVITY	Glycosylation_2
KEGG_FRUCTOSE_AND_MANNOSE_METABOLISM	Glycosylation_2
GO_ATTACHMENT_OF_GPI_ANCHOR_TO_PROTEIN	Glycosylation_2
GO_GLYCOSYLPHOSPHATIDYLINOSITOL_N_ACETYLGLUCOSAMINYLTRANSFERASE_GPI_GNT_COMPLEX	Glycosylation_2
KEGG_GLYCOSYLPHOSPHATIDYLINOSITOL_GPI_ANCHOR_BIOSYNTHESIS	Glycosylation_2
REACTOME_POST_TRANSLATIONAL_MODIFICATION_SYNTHESIS_OF_GPI_ANCHORED_PROTEINS	Glycosylation_2
REACTOME_SYNTHESIS_OF_GLYCOSYLPHOSPHATIDYLINOSITOL_GPI_	Glycosylation_2
GO_GLYCOLIPID_MANNOSYLTRANSFERASE_ACTIVITY	Glycosylation_2
GO_GLYCOLIPID_TRANSPORT	Glycosylation_2
GO_CHONDROITIN_SULFATE_PROTEOGLYCAN_METABOLIC_PROCESS	Glycosylation_2
GO_HEPARAN_SULFATE_PROTEOGLYCAN_METABOLIC_PROCESS	Glycosylation_2
GO_COLLAGEN_ACTIVATED_SIGNALING_PATHWAY	Glycosylation_2
GO_COLLAGEN_ACTIVATED_TYROSINE_KINASE_RECEPTOR_SIGNALING_PATHWAY	Glycosylation_2
GO_COLLAGEN_BINDING	Glycosylation_2
GO_PROTEIN_MANNOSYLATION	Glycosylation_2
GO_PROTEIN_DEMANNOSYLATION	Glycosylation_2
GO_MANNOSYLATION	Glycosylation_2
GO_PROTEIN_O_LINKED_MANNOSYLATION	Glycosylation_3
GO_FUCOSYLATION	Glycosylation_3
GO_FUCOSYLTRANSFERASE_ACTIVITY	Glycosylation_3
GO_PROTEIN_O_LINKED_FUCOSYLATION	Glycosylation_3
GO_ACETYLGALACTOSAMINYLTRANSFERASE_ACTIVITY	Glycosylation_3
GO_BETA_GALACTOSIDASE_ACTIVITY	Glycosylation_3
GO_GALACTOSIDASE_ACTIVITY	Glycosylation_3
GO_GALACTOSYLTRANSFERASE_ACTIVITY	Glycosylation_3
GO_N_ACETYLGALACTOSAMINE_4_O_SULFOTRANSFERASE_ACTIVITY	Glycosylation_3
GO_POLYPEPTIDE_N_ACETYLGALACTOSAMINYLTRANSFERASE_ACTIVITY	Glycosylation_3
GO_UDP_GALACTOSE_BETA_N_ACETYLGLUCOSAMINE_BETA_1_3_GALACTOSYLTRANSFERASE_ACTIVITY	Glycosylation_3
GO_ALPHA_N_ACETYLGALACTOSAMINIDE_ALPHA_2_6_SIALYLTRANSFERASE_ACTIVITY	Glycosylation_3
GO_ALPHA_N_ACETYLNEURAMINATE_ALPHA_2_8_SIALYLTRANSFERASE_ACTIVITY	Glycosylation_3
GO_SIALIC_ACID_BINDING	Glycosylation_3
GO_SIALIC_ACID_TRANSMEMBRANE_TRANSPORTER_ACTIVITY	Glycosylation_3
GO_SIALYLATION	Glycosylation_3
GO_SIALIC_ACID_TRANSPORT	Glycosylation_3
GO_SIALYLTRANSFERASE_ACTIVITY	Glycosylation_3
REACTOME_SIALIC_ACID_METABOLISM	Glycosylation_3
REACTOME_BLOOD_GROUP_SYSTEMS_BIOSYNTHESIS	Glycosylation_3
REACTOME_DERMATAN_SULFATE_BIOSYNTHESIS	Glycosylation_3
REACTOME_CHONDROITIN_SULFATE_BIOSYNTHESIS	Glycosylation_3
KEGG_GLYCOSAMINOGLYCAN_BIOSYNTHESIS_KERATAN_SULFATE	Glycosylation_3
REACTOME_KERATAN_SULFATE_BIOSYNTHESIS	Glycosylation_3
GO_HEPARAN_SULFATE_SULFOTRANSFERASE_ACTIVITY	Glycosylation_3
GO_MUCOPOLYSACCHARIDE_METABOLIC_PROCESS	Glycosylation_3
REACTOME_MUCOPOLYSACCHARIDOSES	Glycosylation_3
GO_HYALURONAN_BIOSYNTHETIC_PROCESS	Glycosylation_3
GO_HYALURONIC_ACID_BINDING	Glycosylation_3
GO_HYALURONONGLUCOSAMINIDASE_ACTIVITY	Glycosylation_3
REACTOME_HYALURONAN_BIOSYNTHESIS_AND_EXPORT	Glycosylation_3
REACTOME_HS_GAG_BIOSYNTHESIS	Glycosylation_3
REACTOME_HS_GAG_DEGRADATION	Glycosylation_3
REACTOME_RUNX3_REGULATES_YAP1_MEDIATED_TRANSCRIPTION	transcription_factor
REACTOME_YAP1_AND_WWTR1_TAZ_STIMULATED_GENE_EXPRESSION	transcription_factor
REACTOME_SIGNALING_BY_ERBB4	transcription_factor
REACTOME_TRANSCRIPTIONAL_REGULATION_OF_PLURIPOTENT_STEM_CELLS	transcription_factor
REACTOME_DEACTIVATION_OF_THE_BETA_CATENIN_TRANSACTIVATING_COMPLEX	transcription_factor
KEGG_ANTIGEN_PROCESSING_AND_PRESENTATION	transcription_factor
REACTOME_FOXO_MEDIATED_TRANSCRIPTION	transcription_factor
PID_MYC_REPRESS_PATHWAY	transcription_factor
REACTOME_UNFOLDED_PROTEIN_RESPONSE_UPR_	transcription_factor
PID_SMAD2_3PATHWAY	transcription_factor
PID_PDGFRA_PATHWAY	receptor_meso
PID_TGFBR_PATHWAY	receptor_meso
ST_INTEGRIN_SIGNALING_PATHWAY	receptor_meso
BIOCARTA_INTEGRIN_PATHWAY	receptor_meso
PID_WNT_CANONICAL_PATHWAY	receptor_meso
BIOCARTA_MET_PATHWAY	receptor_meso
PID_MET_PATHWAY	receptor_meso
REACTOME_SIGNALING_BY_MET	receptor_meso
GO_EPITHELIAL_CELL_MORPHOGENESIS	receptor_meso
GO_BASAL_PLASMA_MEMBRANE	receptor_meso
REACTOME_EPHRIN_SIGNALING	receptor_meso
REACTOME_EPHB_MEDIATED_FORWARD_SIGNALING	receptor_meso
REACTOME_EPH_EPHRIN_SIGNALING	receptor_meso
KEGG_HEDGEHOG_SIGNALING_PATHWAY	receptor_meso
REACTOME_TNF_RECEPTOR_SUPERFAMILY_TNFSF_MEMBERS_MEDIATING_NON_CANONICAL_NF_KB_PATHWAY	receptor_meso
REACTOME_TYPE_I_HEMIDESMOSOME_ASSEMBLY	receptor_meso
REACTOME_INTERLEUKIN_18_SIGNALING	ligand_meso
WP_IL18_SIGNALING_PATHWAY	ligand_meso
REACTOME_MET_ACTIVATES_PTK2_SIGNALING	ligand_meso
REACTOME_MET_PROMOTES_CELL_MOTILITY	ligand_meso
